background:0
player_0:1
ground:-1
ground_left:-1
ground_right:-1
ground_background_full:-1
coin:5
-
500000000000000000000000000000000000000000000000000000000000000000000000000000000000000000000000000000005
500000000000000000000000000000000000000000000000000000000000000000000000000000000000000000000000000000005
500000000000000000000000000000000000000000000000055500000555005550555050500000000000000000000000000000005
500000055500000005050505000505550000000000000000050505550500505050500050500000000000000000000000000000005
500000050505550005050505505505050000000000000000055000000500505550050055500000000000000000000000000000005
500000055500000505050505050505550000000000000000050505550500505050005050500000000000000000000000000000005
500000050505550555055505000505000000000000000000055500000555005050555050500000003222240000000000000000005
500000000000000000000000000000000000000000000000000000000000000000000000000000005555550000000000000000005
500000000000000000000000000000000000322224000000000000000000000000000000000000005555550000000000000000005
500000000001000000000000000000000000555555000000000000000000000000000000000000005555550000000606060000005
522222222222222222222222222222222222222222222222222222222222222222222222222222222222222222222222222222225


