background:0
player_0:1
ground_grass:-1
ground_left_grass:-1
ground_right_grass:-1
ground_background_full:-1
lava:2
spearsup_brown_left:3
spearsup_brown_right:4
coin:5
-
570000000000000000000000000000000000000000000000085
570000000000000000000000000000000000000000009900085
570000000000000009000000000000000000000000003400085
570000000000000322240000000000099000000000000000085
570000009000000000000000000000322400000000000000085
570000322240000000000000000000000000000000000000085
570000000000000000000000100000000000000000000000085
570000000000000000000000000000000999000000000099085
222222266666662222666222226666622222222266622222222
555555555555555555555555555555555555555555555555555
555555555555555555555555555555555555555555555555555
555555555555555555555555555555555555555555555555555
555555555555555555555555555555555555555555555555555
555555555555555555555555555555555555555555555555555
555555555555555555555555555555555555555555555555555

