background:0
player_0:1
ground_cold:-1
ground_left_cold:-1
ground_right_cold:-1
ground_background_full:-1
lava:2
spearsup_gray_left:3
spearsup_gray_right:4
coin:5
-
5700000000000000000000000000000000000085
5700000000000000000000000000000000000085
5700000000000000000000000000000000000085
5700000000000000000000000000000000000085
5700000000000000000000000000000000000085
5700000000000000000000000000000000000085
5700000000000000000000000000000000000085
5700000000000000000000000000000009000085
5700000000000000000000000000000032400085
5700000000000000000000000900000000000085
5700000000000000000000032224000000000085
5700000000000000000000000000000000000085
5700000099000000000000000000000000000085
5700003222240000000000000000000000000085
5700000000000000000000000000000000000085
5700000000000034000000000000000000000085
5700000000000000000000000000000000000085
5700000000000000000000000000090000000085
5700000000000000000000000032222240000085
5700000000000000000000000000000000000085
5700000000000000090000000000000000000085
5700000000000322224000000000000000000085
5700000000000000000000000000000000000085
5700009000000000000000000000000000000085
5703222240000000000000000000000000000085
5700000000000000000000000000000000000085
5700000000000000000000000000000000000085
5700000000000000000034000000000000000085
5700000000000000000000000000909000000085
5700000000000000000000000032222240000085
5700000000000000000000000000000000000085
5700000000000000000000000000000000000085
5700000000000000000000000000000000000085
5700000000000003222400000000000990000085
5700000090000000000000000000000000000085
5700003222400000000000000000003224000085
5700000000000000001000000000000000000085
5700000000000000000000000000000009990085
2226666666666222222222222222222222222222
5555555555555555555555555555555555555555
5555555555555555555555555555555555555555
5555555555555555555555555555555555555555
5555555555555555555555555555555555555555
5555555555555555555555555555555555555555
5555555555555555555555555555555555555555



